Name,Affliation,Conservative,Liberal,Total,Triangles
100monkeystyping.com,Liberal,3,24,27,154
12thharmonic.com/wordpress,Liberal,1,47,48,494
40ozblog.blogspot.com,Liberal,0,0,0,0
4lina.tblog.com,Liberal,0,0,0,0
750volts.blogspot.com,Liberal,1,3,4,1
95theses.blogspot.com,Liberal,0,1,1,0
abbadabbaduo.blogspot.com,Liberal,0,1,1,0
aboutpolitics.blogspot.com,Liberal,1,37,38,181
achingandspinning.blogspot.com,Liberal,1,7,8,17
ackackack.com,Liberal,1,14,15,63
adamtalib.blogspot.com,Liberal,1,0,1,0
adviceforlefty.blogspot.com,Liberal,0,4,4,0
agonist.org,Liberal,4,59,63,771
aintnobaddude.com,Liberal,22,67,89,1349
ajbenjaminjr.blogspot.com,Liberal,2,68,70,671
alicublog.blogspot.com,Liberal,6,48,54,672
allanjenkins.typepad.com,Liberal,0,2,2,0
allspinzone.blogspot.com,Liberal,1,47,48,473
alphapredator.com/wdtgw.htm,Liberal,1,3,4,0
alternateworlds.blogspot.com,Liberal,1,12,13,47
althippo.blogspot.com,Liberal,6,42,48,372
alvintostig.typepad.com,Liberal,3,23,26,137
americablog.blogspot.com,Liberal,8,90,98,1095
americablog.org,Liberal,4,77,81,560
americandreamslost.blogspot.com,Liberal,0,0,0,0
americanmuslim.blogs.com,Liberal,0,1,1,0
americanpolitics.com,Liberal,2,33,35,228
americansforbayh.blogspot.com,Liberal,1,11,12,37
amleft.blogspot.com,Liberal,0,63,63,451
amliberal.com/blog,Liberal,0,1,1,0
amptoons.com/blog,Liberal,9,68,77,1061
anarchyxero.robfindlay.org,Liberal,2,4,6,9
andifeelfine.blogspot.com,Liberal,1,2,3,1
andymatic.com,Liberal,1,4,5,2
angrybear.blogspot.com,Liberal,1,59,60,983
angrydesi.typepad.com,Liberal,2,9,11,42
angryfinger.org,Liberal,0,2,2,0
angryhomo.blogspot.com,Liberal,0,3,3,2
annatopia.com/home.html,Liberal,1,26,27,209
anoldsoul.blogspot.com,Liberal,2,112,114,2168
anonymoussources.blogspot.com,Liberal,0,8,8,9
answerguy.blogspot.com,Liberal,1,14,15,79
anybodybutbushyall.blogspot.com,Liberal,1,3,4,2
anywhichway.net,Liberal,0,1,1,0
arancaytar.blogspot.com,Liberal,0,7,7,5
archpundit.com,Liberal,3,71,74,1130
arkansastonight.com,Liberal,0,3,3,3
asian-nation.org/headlines/index.php,Liberal,0,0,0,0
asiegeofherons.blogspot.com,Liberal,0,0,0,0
asilentrevolution.blogspot.com,Liberal,0,0,0,0
askhoudari.blogspot.com,Liberal,0,1,1,0
astroturf.uni.cc,Liberal,0,1,1,0
atease.blogspot.com,Liberal,0,8,8,10
atomicairship.com,Liberal,0,0,0,0
atrios.blogspot.com,Liberal,22,329,351,6561
"atrios.blogspot.com/ ",Liberal,0,88,88,2099
aurelientt.blogspot.com,Liberal,0,0,0,0
awards5.tripod.com/tarasblog,Liberal,2,2,4,2
b-patton.blogspot.com,Liberal,0,1,1,0
babylon.squarespace.com,Liberal,0,0,0,0
badattitudes.com/mt,Liberal,0,0,0,0
bakshi.us/redskunk,Liberal,0,2,2,0
barcidhomily.com,Liberal,0,0,0,0
barkingdingo.blogspot.com,Liberal,2,5,7,4
bartcop.com,Liberal,0,34,34,163
battleground-wisconsin.blogspot.com,Liberal,0,2,2,0
battlegroundstates.blogspot.com,Liberal,0,2,2,1
beastsbelly.blogspot.com,Liberal,3,20,23,88
bentcorner.blogspot.com,Liberal,0,2,2,0
bettyblog.com,Liberal,0,18,18,93
bigbloosky.blogspot.com,Liberal,0,0,0,0
billmon.org,Liberal,2,148,150,3058
billsrants.blogspot.com,Liberal,0,16,16,51
blackwingleftbird.blogspot.com,Liberal,0,0,0,0
blog.dccc.org,Liberal,1,123,124,1893
blog.dennisfox.net,Liberal,1,2,3,0
blog.glinka.com,Liberal,0,2,2,2
blog.johnkerry.com,Liberal,2,21,23,22
blog.kenlan.net,Liberal,0,12,12,46
blog.mintruth.com,Liberal,3,3,6,3
blog.veggiedude.com,Liberal,2,4,6,3
blog01.kintera.com/dnccblog,Liberal,1,41,42,351
blog01.kintera.com/emilysblog,Liberal,0,1,1,0
bloganonymous.com,Liberal,2,5,7,13
blogforamerica.com,Liberal,0,73,73,611
blogforarizona.com,Liberal,0,3,3,0
blogfreeordie.blogspot.com,Liberal,1,15,16,55
blogitics.com,Liberal,1,4,5,0
blogs.salon.com/0002874,Liberal,6,70,76,895
blogs.salon.com/0003364,Liberal,0,48,48,546
blogs.salon.com/0004024,Liberal,0,0,0,0
blogslut.com,Liberal,2,2,4,1
blosteam.blogspot.com,Liberal,1,3,4,3
blotts.org/polilog,Liberal,0,0,0,0
bluegrassroots.blogspot.com,Liberal,0,7,7,17
bluelemur.com,Liberal,2,13,15,4
blueoregon.com,Liberal,0,7,7,18
bluestateredstate.blogspot.com,Liberal,0,5,5,7
bodyandsoul.typepad.com,Liberal,2,180,182,3870
boffo.typepad.com,Liberal,1,36,37,313
boloboffin.blogspot.com,Liberal,3,63,66,898
bopnews.com,Liberal,0,67,67,660
boston.com/news/blogs/dnc,Liberal,0,6,6,4
bowles2004.com/weblog,Liberal,0,1,1,0
boycottsbg.com,Liberal,0,2,2,0
bradcarson.com/blog,Liberal,0,1,1,0
bradfriedman.com/bradblog,Liberal,0,4,4,4
brianhull.net,Liberal,0,0,0,0
brilliantatbreakfast.blogspot.com,Liberal,4,45,49,535
browncross.com/usualsuspects,Liberal,0,3,3,1
"brunon.blogspot.com ",Liberal,0,0,0,0
bryan08.tk,Liberal,0,0,0,0
btcnews.com/btcnews,Liberal,2,17,19,112
bullmooseblog.com,Liberal,2,31,33,147
burntorangereport.com,Liberal,9,60,69,590
bushlies.net/pages/10/index.htm,Liberal,0,1,1,0
bushmisunderestimated.blogspot.com,Liberal,5,20,25,103
busybusybusy.com,Liberal,1,126,127,2496
buzzmachine.com,Liberal,81,31,112,1122
cadat.nl,Liberal,0,0,0,0
carpetblogger.com,Liberal,0,10,10,27
catchingsmoke.blogspot.com,Liberal,0,0,0,0
cbaker.org/blog,Liberal,2,6,8,16
cemonitor.blogspot.com,Liberal,0,29,29,165
centerpiece.blogspot.com,Liberal,0,6,6,14
chak.org/blog,Liberal,0,0,0,0
changeforamerica.com/blog,Liberal,0,9,9,12
charleypatton.blogspot.com,Liberal,1,1,2,0
charlineandjamie.com/dotnetweb01a/blogdisplay.aspx?logname=jamie&logcatid=48,Liberal,0,1,1,0
chepooka.com,Liberal,4,14,18,34
chestnut_tree.blogspot.com,Liberal,0,0,0,0
chiron.typepad.com,Liberal,7,13,20,47
churchofcriticalthinking.com,Liberal,0,2,2,0
civicactions.com,Liberal,0,0,0,0
cjh9999.blog-city.com,Liberal,0,0,0,0
clarified.blogspot.com,Liberal,8,4,12,18
claudialong.com/blog,Liberal,0,32,32,348
cleancutkid.com,Liberal,0,15,15,86
cnle.net,Liberal,0,0,0,0
collegedems.com/blog,Liberal,0,54,54,633
conniptions.net,Liberal,1,2,3,2
conservativessuck.blogspot.com,Liberal,2,6,8,5
contrapositive.blogspot.com,Liberal,0,5,5,11
corrente.blogspot.com,Liberal,1,177,178,3616
counterspin.blogspot.com,Liberal,3,30,33,235
courtney5.us/drew,Liberal,0,0,0,0
crankylittleblog.blogspot.com,Liberal,0,6,6,7
crapiscommon.blogspot.com,Liberal,0,0,0,0
criticalviewer.com,Liberal,1,6,7,12
crookedtimber.org,Liberal,31,116,147,2466
crooksandliars.com,Liberal,3,21,24,134
dailyblatt.blogspot.com,Liberal,0,2,2,0
dailyblurb.blogspot.com,Liberal,0,0,0,0
dailyhowler.com,Liberal,4,77,81,982
dailykos.com,Liberal,46,338,384,6469
dailywarnews.blogspot.com,Liberal,2,46,48,313
damntheman.net,Liberal,1,10,11,45
dashnier.blogspot.com,Liberal,0,2,2,0
davidsirota.com,Liberal,0,30,30,177
dawnofnewamerica.blogspot.com,Liberal,2,19,21,26
deanocrats.com,Liberal,0,0,0,0
deathpenaltyusa.blogspot.com,Liberal,1,26,27,146
debunker.net,Liberal,0,4,4,4
decksitters.my-expressions.com,Liberal,0,0,0,0
dedspace.blogspot.com,Liberal,1,21,22,60
delraysteve.com/blog,Liberal,0,1,1,0
demagogue.blogspot.com,Liberal,4,70,74,778
demleft.blogspot.com,Liberal,1,32,33,176
democrants.blogspot.com,Liberal,0,0,0,0
democraticunderground.com,Liberal,34,62,96,409
democratreport.blogspot.com,Liberal,0,1,1,0
democrats.org/blog,Liberal,2,100,102,1679
democratvoice.org,Liberal,0,1,1,0
demoliberal.blogspot.com,Liberal,0,0,0,0
dems2000.net,Liberal,0,2,2,0
dems2004.com/blog,Liberal,0,0,0,0
dems2004.org/blog,Liberal,1,37,38,333
denisdekat.com,Liberal,1,6,7,10
dewar.journalspace.com,Liberal,2,9,11,11
digbysblog.blogspot.com,Liberal,7,182,189,4241
digestiblenews.blogspot.com,Liberal,0,51,51,457
digital-democrat.blogspot.com,Liberal,0,1,1,0
digitaldissent.blogspot.com,Liberal,0,0,0,0
digitaljay.blogspot.com,Liberal,1,0,1,0
dimmykarras.blogspot.com,Liberal,2,6,8,4
dir.salon.com/topics/joe_conason/index.html,Liberal,0,13,13,33
discourse.net,Liberal,7,56,63,824
diypolitics.blogdrive.com,Liberal,0,7,7,6
dneiwert.blogspot.com,Liberal,7,156,163,3431
dogfight04.typepad.com,Liberal,1,12,13,47
dohiyimir.typepad.com,Liberal,5,95,100,1206
dolphinsdock.com/blog,Liberal,1,9,10,23
donkey2004.blogspot.com,Liberal,0,3,3,1
donspoliticalblog.blogspot.com,Liberal,0,6,6,4
doublespeakez.blogspot.com,Liberal,0,0,0,0
doubter.blogspot.com,Liberal,0,0,0,0
drugwarmovie.com/drugwarmovie/weblog/blogger.html,Liberal,0,0,0,0
duckdaotsu.blogspot.com,Liberal,0,1,1,0
dygital.blogspot.com,Liberal,0,0,0,0
dystopia.blog-city.com,Liberal,0,3,3,2
eastbaykerry.com,Liberal,0,1,1,0
elayneriggs.blogspot.com,Liberal,2,133,135,2635
elderbearden.blogspot.com,Liberal,3,0,3,0
electablog.com,Liberal,4,41,45,313
elemming2.blogspot.com,Liberal,0,33,33,236
elfoflight.blogspot.com,Liberal,0,0,0,0
elissa.typepad.com,Liberal,0,8,8,16
eltcamerica.blogspot.com,Liberal,0,1,1,0
emergingdemocraticmajority.com,Liberal,1,32,33,268
emergingdemocraticmajorityweblog.com/donkeyrising,Liberal,2,94,96,1031
emptyisform.com,Liberal,5,9,14,25
endthenightmare.blogspot.com,Liberal,0,1,1,0
enemykombatant.blogspot.com,Liberal,1,1,2,0
enlightenedbelle.blogspot.com,Liberal,0,0,0,0
ergio.blogspot.com,Liberal,0,1,1,0
estropundit.blogspot.com,Liberal,1,0,1,0
etherealgirl.blogspot.com,Liberal,2,23,25,54
fafblog.blogspot.com,Liberal,5,75,80,1085
fairshot.org,Liberal,2,54,56,761
farleft.blogspot.com,Liberal,0,14,14,23
fidlet.com,Liberal,0,0,0,0
fiercepoet.com,Liberal,0,3,3,2
flagrancy.net,Liberal,8,29,37,205
folkbum.blogspot.com,Liberal,2,70,72,730
forewarned.blogspot.com,Liberal,1,0,1,0
freakinliberals.com/blog_a,Liberal,0,0,0,0
frederickclarkson.com,Liberal,1,12,13,43
freedompress.blogspot.com,Liberal,0,0,0,0
fromtheroots.org,Liberal,0,63,63,795
fuckthisblog.blogspot.com,Liberal,1,0,1,0
futuraworkz.com,Liberal,0,0,0,0
gabeanderson.com/life,Liberal,0,0,0,0
gadflyer.com,Liberal,0,56,56,432
gaijincory.com,Liberal,0,0,0,0
garbage-house.com,Liberal,0,1,1,0
garrulus.ilcannocchiale.it,Liberal,0,0,0,0
georgewbuy.blogspot.com,Liberal,0,2,2,0
gisleson.com/blog,Liberal,2,52,54,533
global-equality.org/news/blog/index.shtml,Liberal,0,2,2,1
gloomanddoom.blogspot.com,Liberal,0,0,0,0
goose3five.blogspot.com,Liberal,4,52,56,385
gotzfamily.org/weblog,Liberal,0,0,0,0
grassrootsmom.blogspot.com,Liberal,1,13,14,56
grassrootsnation.com,Liberal,0,3,3,1
greaterdemocracy.org,Liberal,0,12,12,6
greendogdemocrat.blogspot.com,Liberal,1,1,2,2
greentit.com,Liberal,0,0,0,0
gregpalast.com,Liberal,0,45,45,156
grupo-utopia.com/blog/isou,Liberal,24,21,45,199
hal9000report.blogdrive.com,Liberal,1,3,4,4
halcyondays.info,Liberal,0,0,0,0
hategun.com,Liberal,0,1,1,0
hellafaded.blogspot.com,Liberal,5,14,19,92
hellofromparis.blogspot.com,Liberal,0,0,0,0
hellskitchennyc.blogspot.com,Liberal,0,1,1,0
hereswhatsleft.typepad.com,Liberal,0,43,43,428
hereswhatsleft.typepad.com/home,Liberal,0,36,36,342
heysucka.blogspot.com,Liberal,0,0,0,0
higherpieproductions.com,Liberal,0,61,61,661
hoeffelforsenate.com/blog,Liberal,0,0,0,0
home.att.net/~dbarnhill,Liberal,0,0,0,0
home.att.net/~gentle.reader,Liberal,0,5,5,6
home.earthlink.net/~cdowner,Liberal,0,0,0,0
home.earthlink.net/~fsrhine,Liberal,1,54,55,496
home.earthlink.net/~heavy-duty,Liberal,0,0,0,0
home.earthlink.net/~juris_doctor_szh,Liberal,0,0,0,0
home.earthlink.net/~kevin.omeara,Liberal,2,2,4,3
home.houston.rr.com/skeptical,Liberal,0,27,27,128
homepage.mac.com/elisa_camahort/iblog,Liberal,0,2,2,0
homepage.mac.com/georgia.nesmith/iblog/index.html,Liberal,0,0,0,0
homepage.mac.com/jpbarr/myblog,Liberal,0,0,0,0
hotflashesfromthecampaigntrail.blogspot.com,Liberal,0,1,1,0
hotflashreport.com,Liberal,1,13,14,32
howienfriends.blogspot.com,Liberal,0,4,4,4
hugozoom.blogspot.com,Liberal,0,7,7,7
ibe.blogspot.com,Liberal,31,7,38,142
ibrutus.com,Liberal,0,6,6,8
iddybud.blogspot.com,Liberal,9,64,73,663
idiosyncratictendencies.com,Liberal,1,3,4,7
idlehandsmag.com/yellowdog04,Liberal,0,3,3,0
iflipflop.com,Liberal,0,13,13,51
ignatz.blogspot.com,Liberal,0,23,23,146
ihatepatrobertson.com,Liberal,1,18,19,77
ilovecynics.com,Liberal,1,0,1,0
in-sub-ordination.blogspot.com,Liberal,0,0,0,0
inez2004.com/blogs,Liberal,0,0,0,0
insanepreschoolmom.blogspot.com,Liberal,0,4,4,2
interestingtimes.blogspot.com,Liberal,1,89,90,1555
interestingtimes.typepad.com,Liberal,0,21,21,105
ironmouth.com,Liberal,0,6,6,13
irregulartimes.com/blogger.html,Liberal,0,1,1,0
islanddave.blogspot.com,Liberal,0,5,5,5
itlookslikethis.blogeasy.com,Liberal,0,8,8,16
itsabitmuch.blogspot.com,Liberal,0,0,0,0
ivotedforgeorge.com,Liberal,1,14,15,47
iwantmycountryback.org,Liberal,23,18,41,283
j-bradford-delong.net/movable_type,Liberal,11,106,117,2049
jadbury.com,Liberal,1,12,13,46
jadbury.com/blog,Liberal,0,15,15,65
jadedreality.blogspot.com,Liberal,1,10,11,32
jameswolcott.com,Liberal,6,77,83,1059
jamiefeyrer.com,Liberal,0,0,0,0
janm.blogspot.com,Liberal,1,9,10,27
jason.unitedworkers.org,Liberal,0,0,0,0
jbcougar.blogspot.com,Liberal,0,7,7,14
jcchurch.blogspot.com,Liberal,0,0,0,0
jdeeth.blogspot.com,Liberal,1,9,10,30
jeremybrendan.blogspot.com,Liberal,0,1,1,0
jetage.blogspot.com,Liberal,0,3,3,4
jewssansfrontieres.blogspot.com,Liberal,0,6,6,4
jimgilliam.com,Liberal,0,6,6,8
jimtreacher.com,Liberal,24,4,28,147
jinkythecat.blogspot.com,Liberal,1,13,14,60
jmbzine.com,Liberal,0,2,2,0
joebrent.blogspot.com,Liberal,4,6,10,11
john.hoke.org,Liberal,1,20,21,59
johnmccrory.com,Liberal,0,43,43,428
johnnynobody.blogspot.com,Liberal,1,3,4,5
jointhecrowd.blogspot.com,Liberal,0,0,0,0
jospehsmind.blogspot.com,Liberal,0,0,0,0
journals.aol.com/breuvers/madashellnotgoingtotakeitanymore,Liberal,0,4,4,0
jpandre.blogspot.com,Liberal,0,0,0,0
juancole.com,Liberal,19,155,174,2672
juandejesus.50megs.com/juancomments.html,Liberal,0,0,0,0
julietterossant.com/superchefblog/superchefblog.html,Liberal,1,0,1,0
juliusblog.blogspot.com,Liberal,0,48,48,591
justmark.com,Liberal,1,0,1,0
karlhenderson.blogspot.com,Liberal,0,5,5,3
karmicsoup.blogspot.com,Liberal,1,3,4,6
katyggls.blogspot.com,Liberal,0,0,0,0
kcdems.blogspot.com,Liberal,0,6,6,13
kensain.com,Liberal,10,19,29,95
kerryforpresident2008.blogspot.com,Liberal,1,8,9,18
kerrytalkingpoints.blogspot.com,Liberal,0,0,0,0
kicktheleftist.blogspot.com,Liberal,1,16,17,84
kiersten.connersax.com,Liberal,0,0,0,0
kiosan.blogharbor.com,Liberal,2,8,10,20
kippsblog.com,Liberal,0,1,1,0
kristyandotherwise.blogspot.com,Liberal,0,0,0,0
kurtkk.blogspot.com,Liberal,0,2,2,1
kydem.blogspot.com,Liberal,0,13,13,47
labandadelbuko.ilcannocchiale.it,Liberal,0,0,0,0
lagernik.blogspot.com,Liberal,0,0,0,0
lastdaysoftherepublic.fatoprofugus.net,Liberal,0,10,10,40
lawdork.blogspot.com,Liberal,5,4,9,10
laylasblog.com,Liberal,0,0,0,0
leanleft.com,Liberal,6,79,85,1489
leavethematrix.blogspot.com,Liberal,0,0,0,0
left2right.typepad.com,Liberal,5,8,13,31
lefterer.com,Liberal,0,24,24,138
lefti.blogspot.com,Liberal,1,26,27,178
leftinthereign.blogspot.com,Liberal,2,2,4,2
leftthought.blogspot.com,Liberal,0,3,3,2
lefttimes.com,Liberal,0,1,1,0
leftwingnation.com,Liberal,0,2,2,2
lendmesomesugar.blogs.com/shut_up_already,Liberal,0,2,2,0
lennonreport.blogspot.com,Liberal,2,7,9,9
leonards-digest.blogspot.com,Liberal,0,3,3,1
lettherebepeace.blogspot.com,Liberal,0,0,0,0
liberalangst.org,Liberal,0,2,2,2
liberalavenger.com,Liberal,4,20,24,96
liberaleric.blogspot.com,Liberal,0,2,2,1
liberaloasis.com,Liberal,2,214,216,5025
liberalreview.blogspot.com,Liberal,0,1,1,0
liberalthunderdome.blogspot.com,Liberal,0,3,3,3
liberationlearning.blogspot.com,Liberal,0,0,0,0
lightupthedarkness.org,Liberal,1,7,8,13
lightupthedarkness.org/blog/default.asp,Liberal,0,6,6,4
limecoconut.blogspot.com,Liberal,0,0,0,0
limericksavant.blogspot.com,Liberal,2,1,3,0
liquidlist.com,Liberal,0,31,31,237
literarybargainville.net,Liberal,0,0,0,0
livejournal.com/users/hoptkov,Liberal,0,2,2,0
livejournal.com/users/jmhm,Liberal,0,39,39,483
livejournal.com/~dailyapple,Liberal,0,0,0,0
livejournal.com/~ladywriter_mts,Liberal,0,0,0,0
loadedmouth.com,Liberal,6,50,56,309
lorenjavier.blogspot.com,Liberal,1,13,14,46
loud-liberal.blogspot.com,Liberal,0,6,6,8
loveamericahatebush.com,Liberal,0,2,2,0
lowrentrat.blogdrive.com,Liberal,1,6,7,10
ltobs.blogspot.com,Liberal,0,1,1,0
ludis.blogspot.com,Liberal,0,14,14,67
ludovicspeaks.typepad.com,Liberal,0,6,6,12
ludovicspeaks.typepad.com/real_deal,Liberal,0,6,6,12
madamepresident2020.blogspot.com,Liberal,0,0,0,0
madkane.com/notable.html,Liberal,13,157,170,3242
maggiespants.co.uk,Liberal,1,1,2,0
mahablog.com,Liberal,2,77,79,1273
marcbrazeau.blogspot.com,Liberal,9,8,17,42
margaretcho.com/blog/blog.htm,Liberal,0,33,33,246
margieburns.com,Liberal,0,1,1,0
markadams.blogdrive.com,Liberal,2,31,33,255
markarkleiman.com,Liberal,16,82,98,1715
markch.blogspot.com,Liberal,0,0,0,0
markschmitt.typepad.com/decembrist,Liberal,1,44,45,414
markwarnerforpresident2008.blogspot.com,Liberal,0,1,1,0
martadonayre.com,Liberal,0,0,0,0
maruthecrankpot.blogspot.com,Liberal,2,64,66,735
massachusetts-liberal.com,Liberal,0,1,1,0
mathewgross.com,Liberal,1,4,5,1
mathewgross.com/blog,Liberal,1,49,50,443
matthewyglesias.com,Liberal,0,1,1,0
maultasch.us,Liberal,1,1,2,2
maxspeak.org/mt,Liberal,7,87,94,1883
mayflowerhill.blogspot.com,Liberal,13,4,17,80
mcwil.blogspot.com,Liberal,0,1,1,0
meanspirit.blogspot.com,Liberal,0,1,1,0
meateatingleftist.com,Liberal,0,17,17,75
mediajunkie.com/edgewise,Liberal,0,39,39,356
mediaprima.com/nv1962,Liberal,0,1,1,0
members.aol.com/ourprez08,Liberal,0,0,0,0
members.cox.net/aaronjohn,Liberal,0,0,0,0
messengerpuppet.com/blog,Liberal,1,1,2,0
metropol47.blogspot.com,Liberal,1,7,8,6
michael124.blogspot.com,Liberal,0,8,8,23
michaelberube.com,Liberal,1,124,125,2929
michaelphillips.blogspot.com,Liberal,4,22,26,133
mickikrimmel.com/redcarpet,Liberal,0,3,3,0
midguard.blogspot.com,Liberal,0,6,6,3
minagahet.blogspot.com,Liberal,0,5,5,3
mirocat.com,Liberal,2,9,11,22
miss-sassafras.com,Liberal,0,0,0,0
misschin.bloggage.com,Liberal,0,3,3,2
missourikid.blog-city.com,Liberal,0,0,0,0
mixtersmix.blogspot.com,Liberal,0,4,4,2
montages.blogspot.com,Liberal,0,12,12,16
moxiegrrrl.com,Liberal,1,6,7,6
mrleft.org,Liberal,1,2,3,2
mrstevebeers.blogspot.com,Liberal,0,0,0,0
msnbc.msn.com/id/3449870,Liberal,6,81,87,1209
mstabile.blogspot.com,Liberal,3,31,34,281
multitudes.typepad.com,Liberal,0,0,0,0
mydd.com,Liberal,10,150,160,2521
myducksoup.com/blog/bloglib/bloglib.shtml,Liberal,0,0,0,0
myleftbrain.com,Liberal,0,33,33,190
myleftthoughts.blogspot.com,Liberal,0,1,1,0
mysterypollster.com/main,Liberal,10,8,18,56
nastyboys.blogspot.com,Liberal,1,4,5,1
nathancallahan.com,Liberal,2,5,7,5
nathannewman.org/log,Liberal,1,77,78,1618
nationalreview.com/frum/frum-diary.asp,Liberal,12,3,15,32
ndnblog.org,Liberal,0,15,15,74
nearouterheaven.blogspot.com,Liberal,0,17,17,120
nebursworld.blogspot.com,Liberal,0,1,1,0
needlenose.com,Liberal,1,35,36,292
nephandus.com/blog.php,Liberal,0,0,0,0
nerofiddled.blogspot.com,Liberal,0,7,7,11
netpolitik.blogspot.com,Liberal,1,39,40,268
netweed.com/postmodernanarchist,Liberal,0,2,2,0
newappeal.blogspot.com,Liberal,0,12,12,59
newdemocrat.blogdrive.com,Liberal,2,6,8,15
newdonkey.com,Liberal,3,31,34,216
newleftblogs.blogspot.com,Liberal,5,174,179,2994
news-opinion.blog-city.com,Liberal,0,0,0,0
newstrolls.com,Liberal,0,0,0,0
nftl.blogspot.com,Liberal,0,0,0,0
niagarabuzz.com,Liberal,0,0,0,0
nickgerman.blogspot.com,Liberal,0,0,0,0
nielsenhayden.com/electrolite,Liberal,3,107,110,2568
nielsenhayden.com/makinglight,Liberal,3,54,57,879
njfordemocracy.org,Liberal,0,1,1,0
njn-blogogram.blogspot.com,Liberal,0,0,0,0
njsoccermom.blogspot.com,Liberal,0,0,0,0
node707.com,Liberal,1,56,57,912
nofearoffreedom.blogspot.com,Liberal,0,5,5,12
nomoremister.blogspot.com,Liberal,3,86,89,1775
norbizness.com,Liberal,8,104,112,2065
noseyonline.com,Liberal,4,64,68,1024
nosmallplans.com/rants,Liberal,0,3,3,3
notbush.com,Liberal,0,3,3,0
notgeniuses.com,Liberal,2,58,60,1055
nuntius.blogspot.com,Liberal,0,0,0,0
nycitystoop.com,Liberal,1,0,1,0
obamablog.com,Liberal,1,16,17,93
obrien4.net/probitus,Liberal,0,0,0,0
obsidianwings.blogs.com,Liberal,29,50,79,885
ocd-gx-liberal.blogspot.com,Liberal,0,0,0,0
oddhours.blogspot.com,Liberal,8,30,38,307
offthekuff.com/mt,Liberal,7,65,72,1061
oipp.blogspot.com,Liberal,0,23,23,127
oliphantparts.org/blog,Liberal,0,0,0,0
oliverwillis.com,Liberal,23,104,127,1810
one38.org,Liberal,2,40,42,355
onetrueblog.com,Liberal,0,0,0,0
onhappiness.crimsonblog.com,Liberal,0,0,0,0
openeyesmemo.com,Liberal,0,2,2,0
orient-lodge.com,Liberal,0,3,3,0
ospolitics.org,Liberal,1,91,92,1849
oxblog.blogspot.com,Liberal,62,25,87,899
pacdaily.com,Liberal,0,2,2,1
pacificviews.org,Liberal,4,128,132,3156
pandagon.net,Liberal,6,165,171,4269
parabasis.typepad.com,Liberal,0,4,4,7
patriotboy.blogspot.com,Liberal,3,100,103,1750
pattymurray.com/blog.php,Liberal,0,3,3,1
paulchasman.com,Liberal,0,1,1,0
peacegarden.blogspot.com,Liberal,2,19,21,93
penheaded.blogspot.com,Liberal,3,4,7,3
pennywit.com/drupal,Liberal,8,2,10,12
permanentred.com,Liberal,3,32,35,182
peskytherat.com/pesky,Liberal,0,1,1,0
phillybri.blogspot.com,Liberal,1,18,19,91
philoponia.blogspot.com,Liberal,1,5,6,7
philosophers-stone.blogspot.com,Liberal,1,4,5,1
philvbblog.blogspot.com,Liberal,0,1,1,0
phoblographer.com,Liberal,3,1,4,3
pinkofeministhellcat.typepad.com/pinko_feminist_hellcat,Liberal,1,56,57,320
planetdave.com/blogs.php3?mid=1,Liberal,1,0,1,0
politicalinsanity.com,Liberal,0,0,0,0
politicalmonitor.us/blog,Liberal,0,8,8,12
politicalstrategy.org,Liberal,4,147,151,3707
politicalthought.net,Liberal,0,2,2,0
politicalwire.com,Liberal,16,87,103,1099
politics.feedster.com,Liberal,18,16,34,220
politicswithrichard.blogspot.com,Liberal,0,1,1,0
polizeros.com,Liberal,0,16,16,79
pollsterseek.blogspot.com,Liberal,3,1,4,0
polstate.com,Liberal,9,34,43,220
popstalin.com/news,Liberal,0,0,0,0
portapulpit.com,Liberal,0,6,6,10
posptect.org/weblog,Liberal,0,0,0,0
praguewriter.typepad.com,Liberal,1,0,1,0
presidentboxer.blogspot.com,Liberal,7,119,126,2599
prestoncaldwellblog.blogspot.com,Liberal,0,7,7,17
probitus.obrien4.net,Liberal,0,0,0,0
profgoose.blogspot.com,Liberal,1,4,5,9
progressivecyclone.blogspot.com,Liberal,0,0,0,0
progressivedialogue.com,Liberal,0,0,0,0
progressiveink.com,Liberal,0,4,4,2
progressiveink.com/bloggers.php,Liberal,0,0,0,0
progressivesociety.com/blog,Liberal,0,10,10,41
progressivetrail.org/blog.shtml,Liberal,0,0,0,0
proponentofreason.blogspot.com,Liberal,0,2,2,0
prospect.org/weblog,Liberal,14,131,145,3571
pudentilla.blogspot.com,Liberal,0,40,40,491
punditician.blogspot.com,Liberal,0,2,2,1
purplestates.blogspot.com,Liberal,1,6,7,16
qando.net,Liberal,67,19,86,761
question-dean.blogspot.com,Liberal,0,3,3,1
radgeek.com,Liberal,0,7,7,10
radikal_papi.pitas.com,Liberal,0,1,1,0
radio.weblogs.com/0131587/categories/flush,Liberal,0,1,1,0
raedinthemiddle.blogspot.com,Liberal,2,25,27,114
randz.net,Liberal,0,0,0,0
rantingred.blogspot.com,Liberal,0,0,0,0
reachm.com/amstreet,Liberal,9,132,141,3412
readingpost.com,Liberal,1,5,6,1
realitybasednation.com,Liberal,2,5,7,11
red-harvest.blogspot.com,Liberal,0,10,10,41
religiousleft.blogspot.com,Liberal,0,6,6,12
republicansbite.com,Liberal,0,0,0,0
republicoft.typepad.com,Liberal,0,5,5,0
resistoppression.blogspot.com,Liberal,0,2,2,0
restoreamerica.blogspot.com,Liberal,0,6,6,7
retrogrouch.net,Liberal,0,39,39,501
revoltnow-us.blogspot.com,Liberal,0,0,0,0
reynardfox.com,Liberal,0,0,0,0
rhetoricrhythm.blogspot.com,Liberal,13,43,56,597
righthandthief.blogspot.com,Liberal,2,42,44,480
rising-hegemon.blogspot.com,Liberal,3,71,74,1311
risinghegemon.blogspot.com,Liberal,2,12,14,53
rittenhouse.blogspot.com,Liberal,2,86,88,1979
riverbendblog.blogspot.com,Liberal,4,71,75,449
rkook.blogspot.com,Liberal,0,0,0,0
roadtosurfdom.com,Liberal,4,87,91,2088
robot-invasion.com,Liberal,2,20,22,100
robschumacher.blogspot.com,Liberal,6,83,89,830
rockthrower.blogs.com/rockthrower,Liberal,0,0,0,0
rogerailes.blogspot.com,Liberal,2,115,117,2803
roil.blogspot.com,Liberal,0,0,0,0
rooksrant.com,Liberal,1,36,37,209
rowhouselogic.com,Liberal,0,32,32,320
roxanne.typepad.com,Liberal,6,98,104,1426
rudepundit.blogspot.com,Liberal,6,54,60,515
rudyforfreeholder.org,Liberal,0,0,0,0
ruminatethis.com,Liberal,0,48,48,793
s88172659.onlinehome.us/spockosbrain.html,Liberal,0,5,5,12
sadlyno.com,Liberal,2,66,68,1101
saveoursenate.blogspot.com,Liberal,0,5,5,11
savetheus.blogspot.com,Liberal,0,0,0,0
saxa.blogspot.com,Liberal,0,0,0,0
sccdp.org/blog.php,Liberal,1,12,13,22
schadelmann.com,Liberal,0,3,3,2
scoobiedavis.blogspot.com,Liberal,2,89,91,1654
scott-niven.com/saltwaterpizza,Liberal,0,0,0,0
scottcsmith.net,Liberal,4,16,20,47
scripting.com,Liberal,10,11,21,40
scrutinyhooligans.blogspot.com,Liberal,2,41,43,497
seeingtheforest.com,Liberal,0,12,12,62
seetheforest.blogspot.com,Liberal,2,83,85,1746
senatorbarb.typepad.com,Liberal,0,0,0,0
senorpez.com,Liberal,0,0,0,0
sequiturnon.blog-city.com,Liberal,0,0,0,0
sethdmichaels.com,Liberal,0,2,2,0
shakespearessister.blogspot.com,Liberal,6,34,40,273
shamelessantagonist.blogspot.com,Liberal,3,4,7,7
sharedthought.com/weblog,Liberal,0,5,5,7
shetquaker.blog-city.com,Liberal,0,0,0,0
shininglight.us,Liberal,9,6,15,16
shoegal.modblog.com,Liberal,0,2,2,0
shotofpolitics.blogspot.com,Liberal,18,10,28,156
shrillblog.blogspot.com,Liberal,1,10,11,34
simbaud.blogspot.com,Liberal,2,100,102,1987
simplyappalling.blogspot.com,Liberal,1,9,10,19
skipperstyle.com,Liberal,0,0,0,0
small-hands.blogspot.com,Liberal,0,0,0,0
smearbody.blogspot.com,Liberal,0,0,0,0
smirkingchimp.com,Liberal,2,54,56,529
smithersmpls.com,Liberal,8,19,27,159
snooty.binaryclub.com/wp-rdf.php,Liberal,0,0,0,0
snunes.blogspot.com,Liberal,0,77,77,1667
someonetakethewheel.blogspot.com,Liberal,0,4,4,2
soonerthought.com,Liberal,1,4,5,3
southknoxbubba.net/skblog,Liberal,17,99,116,2552
spacedog26.blogspot.com,Liberal,0,1,1,0
spectatorsport.blogspot.com,Liberal,0,11,11,35
stagefour.typepad.com/commonprejudice,Liberal,1,96,97,2776
stalinism.com/shot-by-both-sides,Liberal,4,11,15,58
stcfoundation.blogspot.com,Liberal,2,41,43,619
stephenbates.com/yellowdoggereldemocrat,Liberal,1,22,23,113
stevecopy.blogharbor.com,Liberal,0,6,6,2
stevegilliard.blogspot.com,Liberal,1,77,78,1485
steveguy.me.uk,Liberal,1,0,1,0
stevemacek.blogspot.com,Liberal,0,4,4,4
stillfighting.blogspot.com,Liberal,0,10,10,37
stirs-the-pot.blogspot.com,Liberal,0,0,0,0
stitt.blogspot.com,Liberal,0,1,1,0
stonyfield.com/weblog/bovinebugle/index.html,Liberal,0,0,0,0
stonyfield.com/weblog/strongwomendailynews/index.html,Liberal,0,0,0,0
strangedoctrines.typepad.com,Liberal,10,27,37,323
strangesemantics.blogspot.com,Liberal,1,0,1,0
stzman.org/blog,Liberal,0,0,0,0
suburbanguerrilla.blogspot.com,Liberal,2,72,74,1400
swamiuptown.com,Liberal,0,6,6,11
swingleft.blogspot.com,Liberal,0,0,0,0
swingstateproject.com,Liberal,1,27,28,229
takeaction.blog-city.com,Liberal,0,0,0,0
takeactionmichigan.blog-city.com,Liberal,0,0,0,0
takebackthemedia.com,Liberal,0,43,43,423
talkingpointsmemo.com,Liberal,41,242,283,6130
talkleft.com,Liberal,22,140,162,3727
tallone.org,Liberal,2,0,2,0
tbogg.blogspot.com,Liberal,7,163,170,5989
teenageenthusiast.blogspot.com,Liberal,0,22,22,113
tesibria.typepad.com/democracy_is_coming,Liberal,0,4,4,8
thatcoloredfellasweblog.bloghorn.com,Liberal,3,30,33,199
thatgoodnight.com,Liberal,0,14,14,81
the-goddess.org,Liberal,1,23,24,162
the-hamster.com,Liberal,0,70,70,1387
theaggpro.blogspot.com,Liberal,0,1,1,0
theagitator.blogspot.com,Liberal,0,15,15,102
theangryliberal.blogspot.com,Liberal,0,5,5,10
theantibush.org,Liberal,0,1,1,0
theapologist.blogspot.com,Liberal,0,1,1,0
thebarrexam.blogspot.com,Liberal,0,0,0,0
theblogwarrior.blogspot.com,Liberal,1,3,4,1
thebluestate.com,Liberal,0,0,0,0
theblueview.blogspot.com,Liberal,1,21,22,19
thecarpetbaggerreport.com,Liberal,0,39,39,397
thecore4.com,Liberal,1,17,18,105
thefulcrum.blogspot.com,Liberal,2,20,22,110
theimmoralminority.blogspot.com,Liberal,0,0,0,0
theleftcoaster.com,Liberal,4,128,132,3359
thelefthand.blogspot.com,Liberal,0,0,0,0
thelonedem.com,Liberal,0,1,1,0
thelucideye.blogspot.com,Liberal,0,7,7,13
thepeach.blogspot.com,Liberal,0,5,5,7
thepoorman.net,Liberal,15,96,111,2608
theradiomansays.blogspot.com,Liberal,0,1,1,0
therogueangel.com/blog,Liberal,0,8,8,9
therustybarrel.com/david/blog,Liberal,0,0,0,0
thesiliconmind.blogspot.com,Liberal,0,0,0,0
thesnooter.blogspot.com,Liberal,0,2,2,0
thetalentshow.org,Liberal,5,84,89,1964
thetalkingdog.com,Liberal,20,78,98,2457
thewashingtonnote.com,Liberal,2,34,36,317
thewilson.blogspot.com,Liberal,0,0,0,0
theworldaroundyou.com,Liberal,5,3,8,11
thewritewing.blogspot.com,Liberal,0,3,3,4
theyetimn.blogspot.com,Liberal,0,11,11,11
thingsasitis.net,Liberal,0,1,1,0
think2004.com,Liberal,0,6,6,9
thinkingrocks.blogspot.com,Liberal,1,2,3,2
thirdredeye.blogspot.com,Liberal,1,7,8,11
thislousytshirt.net,Liberal,0,2,2,0
thismodernworld.com,Liberal,3,103,106,1921
thomasblog.typepad.com/bloggg,Liberal,2,42,44,605
thunewatch.squarespace.com,Liberal,0,2,2,0
tinylittledots.com,Liberal,0,1,1,0
tobyemden.blogspot.com,Liberal,1,8,9,12
tom_thinks.blogspot.com,Liberal,0,0,0,0
tomburka.com,Liberal,1,42,43,598
tomcoburnisabigfatjerk.blogspot.com,Liberal,0,18,18,95
tomdaschle.com/tom/index.php?id=34,Liberal,0,0,0,0
tomherod.blogspot.com,Liberal,0,1,1,0
tonyknowles.com/blog.html,Liberal,0,0,0,0
topviewnews.com/blog,Liberal,0,0,0,0
toteota.blogspot.com,Liberal,0,68,68,1356
trainorphans.org,Liberal,0,1,1,0
translucence.org,Liberal,0,1,1,0
travalex.blogspot.com,Liberal,0,18,18,80
tristero.blogspot.com,Liberal,0,41,41,673
trueconservative.typepad.com,Liberal,0,2,2,2
truedemocrat.blogspot.com,Liberal,0,1,1,0
truthbenotproud.blogspot.com,Liberal,0,0,0,0
tuibguy.messagemonster.com,Liberal,0,0,0,0
turnpikefeminist.com,Liberal,0,5,5,6
turnspit.com,Liberal,1,3,4,0
uberddue.blogspot.com,Liberal,0,0,0,0
uberdude.blogspot.com,Liberal,2,19,21,153
uggabugga.blogspot.com,Liberal,2,57,59,1088
unodemocrats.com/blog,Liberal,1,6,7,15
upper-left.blogspot.com,Liberal,2,28,30,310
urbandemocracy.blogspot.com,Liberal,0,5,5,12
urbanecoinc.com/wordpress1,Liberal,0,1,1,0
usademocrazy.blogspot.com,Liberal,0,1,1,0
usliberals.about.com,Liberal,0,2,2,0
uwaythinks.blogspot.com,Liberal,0,0,0,0
vernsblog.thegillfamily.us:8180,Liberal,1,1,2,1
virginiaprogressive.blogspot.com,Liberal,1,6,7,10
vocis.com/frank,Liberal,0,3,3,0
votekerryedwards2004.blogspot.com,Liberal,0,0,0,0
votervirginblog.blogspot.com,Liberal,0,0,0,0
waitingfordorothy.blogspot.com,Liberal,2,12,14,37
wampum.wabanaki.net,Liberal,1,116,117,3895
warandpiece.com,Liberal,8,54,62,959
warriorsblog.blogspot.com,Liberal,0,0,0,0
washingtonmonthly.com,Liberal,51,205,256,7278
watchingthewatchers.org,Liberal,0,11,11,13
waveflux.net,Liberal,2,9,11,39
weblogs.bakshi.us/redskunk,Liberal,0,2,2,0
werenotallincompetent.blogspot.com,Liberal,0,0,0,0
whirlingbuffalo.com/creative-spirits.htm,Liberal,0,0,0,0
whopundit.blogspot.com,Liberal,0,14,14,79
whoviating.blogspot.com,Liberal,1,31,32,362
whyareweback.blogspot.com,Liberal,6,40,46,278
winnegar.blog-city.com,Liberal,0,1,1,0
winthewest.blogspot.com,Liberal,0,6,6,10
woneffe.typepad.com,Liberal,0,1,1,0
wonkette.com,Liberal,37,93,130,1498
workingpapers.blogspot.com,Liberal,0,0,0,0
worldonfire.typepad.com/world_on_fire,Liberal,1,26,27,276
wpblog.ohpinion.com,Liberal,2,1,3,0
wsrblood.typepad.com/wiserblog,Liberal,0,3,3,0
wtf.mindsay.com,Liberal,0,0,0,0
wtpm.blogspot.com,Liberal,0,14,14,87
wynterstoner.blogspot.com,Liberal,0,0,0,0
x-pollen.com/many/blog.html,Liberal,1,4,5,2
xanga.com/allegrad,Liberal,0,0,0,0
xanga.com/home.aspx?user=phknrocket1k,Liberal,0,0,0,0
xanga.com/kerry4president,Liberal,0,0,0,0
xianleft.blogspot.com,Liberal,0,0,0,0
xnerg.blogspot.com,Liberal,10,132,142,4373
yarsrevenge.blogspot.com,Liberal,2,39,41,742
yglesias.typepad.com/matthew,Liberal,24,117,141,3170
yoder.ru,Liberal,0,1,1,0
younglibs.com,Liberal,0,1,1,0
84rules.blog-city.com,Conservative,0,0,0,0
a100wwe.blogspot.com,Conservative,5,0,5,10
absurd-canadian.blogspot.com,Conservative,2,0,2,0
ace.mu.nu,Conservative,138,4,142,1536
aceoftrumpblog.blogspot.com,Conservative,13,0,13,15
acepilots.com/mt,Conservative,58,7,65,455
acertainslantoflight.blogspot.com,Conservative,64,14,78,931
achicknamedmarzi.com,Conservative,8,0,8,10
activistchat.com/blogiran,Conservative,53,0,53,235
adeimantus.blogspot.com,Conservative,17,0,17,21
adonai.cc,Conservative,0,0,0,0
airjun.blogspot.com,Conservative,0,0,0,0
alamodispatches.blogspot.com,Conservative,2,0,2,2
alamonation.blogspot.com,Conservative,30,0,30,123
alarmingnews.com,Conservative,77,9,86,756
aldaron.modblog.com,Conservative,4,0,4,0
aldaynet.org,Conservative,113,2,115,591
alexpelan.blogspot.com,Conservative,2,0,2,0
alittlemoretotheright.com,Conservative,51,2,53,375
all-encompassingly.com,Conservative,45,1,46,204
allahpundit.com,Conservative,37,2,39,144
allthingsmark.com,Conservative,1,0,1,0
alphapatriot.com,Conservative,97,8,105,885
althouse.blogspot.com,Conservative,39,5,44,277
americaindenial.com/?q=node/feed,Conservative,0,0,0,0
americanchronicle.blogspot.com,Conservative,7,0,7,7
americancommentator.blogs.com/the_american_commentator_,Conservative,0,0,0,0
americandigest.org,Conservative,33,1,34,234
americandinosaur.blogspot.com,Conservative,35,2,37,131
americanfuture.typepad.com,Conservative,25,9,34,263
americanjihad.blogspot.com,Conservative,0,0,0,0
americankernel.com,Conservative,3,0,3,1
americanreport.blogspot.com,Conservative,12,1,13,44
americanthinker.com,Conservative,34,0,34,127
americanwarmonger.blogspot.com,Conservative,56,5,61,176
americanworldview.tripod.com/weltansblog,Conservative,1,0,1,0
americasteen.tk,Conservative,0,0,0,0
amigo13.blogspot.com,Conservative,13,0,13,48
amradio.blogspot.com,Conservative,1,1,2,0
andrewsullivan.com,Conservative,86,59,145,1206
andrightlyso.blogspot.com,Conservative,1,0,1,0
angrychineseblogger.blog-city.com,Conservative,1,0,1,0
angrygwn.blogspot.com,Conservative,15,2,17,48
anncoulter.org,Conservative,34,1,35,75
annika.mu.nu,Conservative,23,2,25,86
anothervrwc.blogspot.com,Conservative,2,0,2,0
antijohnkerry.blogspot.com,Conservative,14,1,15,23
antiprotester.blogspot.com,Conservative,33,1,34,177
apologiesdemanded.blogspot.com,Conservative,32,3,35,234
arkanssouri.blogspot.com,Conservative,6,2,8,4
armchairgeneralist.typepad.com,Conservative,1,13,14,57
asmallvictory.net,Conservative,73,4,77,805
asmodeus-space.com/weblog/blog/index.php,Conservative,7,0,7,3
astrosoup.blogspot.com,Conservative,2,0,2,1
athena.blogs.com,Conservative,29,1,30,194
awideawake.blogspot.com,Conservative,29,0,29,138
ayerdis.com/rants.php,Conservative,20,1,21,108
babytrollblog.com,Conservative,54,1,55,469
baldilocks.typepad.com,Conservative,54,0,54,345
balloon-juice.com,Conservative,82,29,111,1437
bamapachyderm.blogspot.com,Conservative,3,0,3,1
batr.net,Conservative,4,0,4,1
batr.org/commentary.html,Conservative,3,0,3,1
beautifulatrocities.com,Conservative,39,1,40,162
beefalwayswins.blogspot.com,Conservative,20,1,21,101
beldar.blogs.com/beldarblog,Conservative,63,9,72,1054
bellusbellum.info,Conservative,2,0,2,2
belmontclub.blogspot.com,Conservative,119,4,123,1543
bensgtusmc.com,Conservative,3,0,3,4
bensworld.patriotforum.org,Conservative,13,2,15,30
bernardmoon.blogspot.com,Conservative,17,4,21,80
betsyspage.blogspot.com,Conservative,35,2,37,235
bidinotto.journalspace.com,Conservative,8,0,8,5
bigenchilada.org,Conservative,0,0,0,0
bigfatroid.blogspot.com,Conservative,3,0,3,1
bigjourney.blogspot.com,Conservative,1,0,1,0
billhobbs.com,Conservative,99,5,104,1413
billrice.org,Conservative,5,6,11,36
billroggio.com/easongate,Conservative,45,5,50,407
bitheads.blogspot.com,Conservative,25,5,30,154
bittersweetme.net/blog/index.php,Conservative,26,0,26,110
bkennelly.com/vox,Conservative,3,1,4,1
blackmanforbush.blogspot.com,Conservative,6,0,6,8
blindmindseye.com,Conservative,12,0,12,25
blithered.blogspot.com,Conservative,41,0,41,177
blog.iainlindley.com,Conservative,0,0,0,0
blog.mytechaid.com,Conservative,0,0,0,0
blog.nam.org,Conservative,1,0,1,0
blog.ncsweb.us,Conservative,11,0,11,27
blog.so-amazing.net,Conservative,1,0,1,0
blog.willrobinson47.com,Conservative,3,0,3,2
bloghogger.blogspot.com,Conservative,3,0,3,0
blogicus.com,Conservative,59,3,62,376
blogodob.blogspot.com,Conservative,42,2,44,337
blogs.blogosphere.ca/brock,Conservative,0,0,0,0
blogsagainsthillary.com,Conservative,45,0,45,107
blogsforbush.com,Conservative,463,5,468,2821
blogsofwar.com,Conservative,108,14,122,1488
blogspirator.blogspot.com,Conservative,17,3,20,57
blubberhollow.com/blog,Conservative,4,0,4,3
blue6golf.blogspot.com,Conservative,7,0,7,16
bluegoldfish.blogs.com/surface,Conservative,21,2,23,74
bluestates.blogspot.com,Conservative,2,7,9,27
bobhayes.net,Conservative,27,1,28,67
boottotheskull.com,Conservative,2,0,2,0
borgardblog.blogspot.com,Conservative,9,0,9,30
brainshavings.com,Conservative,35,2,37,150
brendonsspiderhole.blogspot.com,Conservative,0,0,0,0
brianlarry.com,Conservative,0,0,0,0
brianscott.blogspot.com,Conservative,1,0,1,0
brutallyhonest.org,Conservative,9,0,9,20
buckeyepundit.blogspot.com,Conservative,5,0,5,1
bullmooserepublicans.com/blog,Conservative,5,0,5,4
bushblog.us,Conservative,21,0,21,62
c-pol.blogspot.com,Conservative,14,0,14,29
californiaconservatives4truth.blogspot.com,Conservative,17,0,17,37
calirep.blogspot.com,Conservative,6,0,6,3
calpoly.edu/~doleary/blog.htm,Conservative,5,0,5,4
campaignofone.org/blog/index.asp,Conservative,0,0,0,0
captainsquartersblog.com/mt,Conservative,131,7,138,1702
catscape.com,Conservative,16,4,20,44
cayankee.blogs.com,Conservative,131,11,142,1819
cbcbcbcb.blogspot.com,Conservative,17,0,17,69
ccs178.com,Conservative,13,0,13,13
cdharris.net,Conservative,41,1,42,303
cecile.squarespace.com,Conservative,1,0,1,0
celluloid-wisdom.com/pw,Conservative,72,7,79,764
celluloid-wisdom.com/pw/,Conservative,29,10,39,210
centinel.blogspot.com,Conservative,3,2,5,1
chadster.capitalfocus.org,Conservative,2,0,2,0
chainik_hocker.blogspot.com,Conservative,3,0,3,2
charlesking.blogspot.com,Conservative,1,0,1,0
chiefsblog.blogspot.com,Conservative,5,1,6,2
chrenkoff.blogspot.com,Conservative,115,4,119,1268
christian-patriot.blogspot.com,Conservative,22,1,23,66
civilcommotion.com,Conservative,4,0,4,3
claycalhoun.com,Conservative,32,3,35,210
claytoncorner.blogspot.com,Conservative,2,1,3,1
clubforgrowth.org/blog,Conservative,18,1,19,32
cmillertime.blogspot.com,Conservative,13,0,13,16
coffee.ondragonswing.com,Conservative,14,0,14,19
commonsenserunswild.typepad.com,Conservative,90,5,95,1172
confederateyankee.blogspot.com,Conservative,21,0,21,65
conpro.blogspot.com,Conservative,0,0,0,0
conservativeblogger.com,Conservative,5,0,5,5
conservativecat.com,Conservative,22,0,22,44
conservativecitizen.blogspot.com,Conservative,0,0,0,0
conservativedhc.blogspot.com,Conservative,0,0,0,0
conservativedialysis.com,Conservative,38,2,40,198
conservativeeyes.blogspot.com,Conservative,40,1,41,141
conservativelife.com/blog,Conservative,42,2,44,301
conservativenation.us,Conservative,1,0,1,0
conservativeobserver.blogspot.com,Conservative,2,3,5,1
conservativepolitics.blogspot.com,Conservative,1,0,1,0
conservativepunk.com,Conservative,11,0,11,4
conservativepush.blogspot.com,Conservative,6,0,6,3
conservativeresponse.com,Conservative,5,0,5,3
conservativerevolution.com,Conservative,22,0,22,122
conservativevor.blogdrive.com,Conservative,0,0,0,0
conservativezone.blogspot.com,Conservative,13,2,15,61
coxandforkum.com,Conservative,114,1,115,1175
cptnwinky.com,Conservative,3,0,3,0
crankybastard.blogspot.com,Conservative,30,0,30,140
crankyneocon.com/crankyneocon,Conservative,41,2,43,262
criticalbill.blogspot.com,Conservative,0,0,0,0
cruelkev.blogspot.com,Conservative,0,0,0,0
cubanstories.blogspot.com,Conservative,5,0,5,3
cybermenace.blogspot.com,Conservative,2,0,2,0
cynicalnation.com,Conservative,51,10,61,528
cynscorion.com/v-web/b2/index.php,Conservative,0,0,0,0
d-42.com,Conservative,2,0,2,0
daddypundit.blogspot.com,Conservative,25,0,25,78
dadougster.blogspot.com,Conservative,2,0,2,1
dailypundit.com,Conservative,41,5,46,357
dailyrecycler.com/blog,Conservative,18,2,20,46
daisycutter.blogspot.com,Conservative,43,3,46,275
dalythoughts.com,Conservative,97,17,114,1483
danieldrezner.com/blog,Conservative,60,31,91,1279
danzfamily.com,Conservative,21,0,21,78
dartblog.com,Conservative,17,1,18,70
datingrepublicans.com,Conservative,1,0,1,0
deadcantrant.com/blog,Conservative,17,1,18,59
deanesmay.com,Conservative,86,9,95,1080
deansjournal.blogspot.com,Conservative,16,0,16,50
decision08.blogspot.com,Conservative,38,8,46,241
denbeste.nu,Conservative,55,3,58,402
depressedlonelybored.typepad.com,Conservative,2,0,2,2
deserttusk.blogspot.com,Conservative,19,0,19,57
devildawg.blogspot.com,Conservative,17,1,18,60
dgci.blog-city.com,Conservative,0,0,0,0
dgci.net,Conservative,27,0,27,82
diggersrealm.com/mt,Conservative,33,3,36,224
dilusionl.blogspot.com,Conservative,3,0,3,0
diplomadic.blogspot.com,Conservative,57,0,57,254
discerningtexan.blogspot.com,Conservative,77,2,79,911
discountblogger.com,Conservative,3,0,3,2
disintegrator.blogspot.com,Conservative,11,0,11,11
dissectleft.blogspot.com,Conservative,89,7,96,773
dividedloyalties.net,Conservative,0,0,0,0
dizzy-girl.net/index.php,Conservative,7,0,7,1
dmobley.blogspot.com,Conservative,16,0,16,57
dogwooddreams.com/serendipity,Conservative,3,0,3,2
donaldsensing.com,Conservative,57,6,63,573
downtownlad.blogspot.com,Conservative,5,1,6,7
drudgereport.com,Conservative,212,33,245,1287
drumwaster.com,Conservative,12,0,12,16
drunkensamurai.blogspot.com,Conservative,10,0,10,12
dummocrats.com,Conservative,80,1,81,923
dynamist.com/weblog,Conservative,50,14,64,758
economicswithaface.com/weblog,Conservative,11,4,15,29
edmondthehun.blogspot.com,Conservative,0,0,0,0
eeg3.com,Conservative,3,1,4,3
ejectejecteject.com,Conservative,50,0,50,353
electionprojection.com,Conservative,59,9,68,560
electricvenom.com,Conservative,37,5,42,253
elevendayempire.com/movabletype,Conservative,22,2,24,78
emilythedog.blogspot.com,Conservative,7,1,8,9
epubguy.blogs.com/epubguy,Conservative,0,0,0,0
erickohn.com,Conservative,11,0,11,20
erikack.blogspot.com,Conservative,2,0,2,0
etalkinghead.com,Conservative,44,31,75,146
evangelicaloutpost.com,Conservative,148,2,150,1269
everythingiknowiswrong.com,Conservative,66,2,68,479
evilpundit.com,Conservative,20,0,20,80
fearfulsymmetry.blogspot.com,Conservative,2,0,2,1
firstdownpolitics.com,Conservative,2,0,2,0
flyinspacemonkey.mu.nu,Conservative,0,0,0,0
fooswah.com,Conservative,0,0,0,0
franklog.com,Conservative,1,0,1,0
fraterslibertas.com,Conservative,38,0,38,241
freedomofthought.com,Conservative,15,0,15,26
freerepublic.com,Conservative,67,14,81,194
fringeblog.com,Conservative,10,0,10,26
fritzs-thoughts.blogspot.com,Conservative,9,0,9,5
gaypatriot.blogspot.com,Conservative,36,4,40,269
gccpundit.blogspot.com,Conservative,6,0,6,10
gcruse.typepad.com,Conservative,15,0,15,23
georgewbush.com,Conservative,69,13,82,149
georgewbush.com/blog,Conservative,0,0,0,0
gerberatetra.blogspot.com,Conservative,22,1,23,94
getdexview.barrennorth.com,Conservative,0,0,0,0
gevkaffeegal.typepad.com/the_alliance,Conservative,209,3,212,857
ghostofaflea.com,Conservative,16,4,20,52
gillaand.blogspot.com,Conservative,0,0,0,0
gindy.blogspot.com,Conservative,14,2,16,33
gmscorner.blogspot.com,Conservative,22,5,27,137
godubya.com,Conservative,2,0,2,0
gopandcollege.blogspot.com,Conservative,3,0,3,1
gopandthecity.blogspot.com,Conservative,28,1,29,120
gopbloggers.org,Conservative,73,1,74,292
gopinsight.com,Conservative,28,0,28,34
gotdesign.blogspot.com,Conservative,22,0,22,81
gracefotography.com/graceblog/index.php,Conservative,0,0,0,0
grantb88.com,Conservative,0,0,0,0
greatestjeneration.com,Conservative,31,0,31,213
grownups.blogspot.com,Conservative,1,0,1,0
gullyborg.typepad.com,Conservative,20,0,20,57
gwbblows.blogspot.com,Conservative,0,0,0,0
happyhomeschooler.blog-city.com,Conservative,1,0,1,0
hasidicgentile.org,Conservative,1,0,1,0
hathaby.net/weblog.php,Conservative,2,0,2,0
headland.blogspot.com,Conservative,17,0,17,70
healingiraq.blogspot.com,Conservative,35,13,48,219
heathenfolk.warblogs.com/blog,Conservative,0,0,0,0
heavylifting.blogspot.com,Conservative,2,0,2,1
hectorvex.blogspot.com,Conservative,19,0,19,72
henerd.com,Conservative,2,0,2,0
hiddennook.blogspot.com,Conservative,12,1,13,39
hijkselur.blogspot.com,Conservative,0,0,0,0
hillcountryviews.blogspot.com,Conservative,23,2,25,87
hipublican.com,Conservative,2,0,2,1
hobsonschoice.us,Conservative,1,0,1,0
holecard.blogspot.com,Conservative,30,2,32,235
home.earthlink.net/~goodnoughp/index.html,Conservative,0,0,0,0
home.earthlink.net/~jasider,Conservative,0,0,0,0
home.earthlink.net/~techservant,Conservative,3,0,3,3
home.earthlink.net/~ur_blog,Conservative,0,0,0,0
home.midsouth.rr.com/joefish,Conservative,30,0,30,155
homespunbloggers.blogspot.com,Conservative,72,4,76,173
homicidalmaniak.com,Conservative,14,1,15,27
hoosierparliament.com,Conservative,0,0,0,0
horologium.net,Conservative,32,0,32,181
hughhewitt.com,Conservative,209,16,225,3836
iamaugustus.blogspot.com,Conservative,2,0,2,2
ideastockexchange.com/essays/laubs-mike-interest-politics-web-log.htm,Conservative,0,0,0,0
ikilledcheguevara.blogspot.com,Conservative,8,1,9,8
imao.us,Conservative,87,2,89,834
imprescindibile.ilcannocchiale.it,Conservative,1,0,1,0
incite1.blogspot.com,Conservative,95,9,104,834
indcjournal.com,Conservative,98,11,109,1379
indepundit.com,Conservative,31,4,35,141
inmyrightmind.com,Conservative,0,0,0,0
instapundit.com,Conservative,297,66,363,7568
interested-participant.blogspot.com,Conservative,37,5,42,181
inthebullpen.com,Conservative,57,0,57,548
iowageek.blogspot.com,Conservative,43,4,47,339
iraqthemodel.blogspot.com,Conservative,96,8,104,1094
isaacspolitics.blogspot.com,Conservative,0,0,0,0
isdl.blogspot.com,Conservative,9,0,9,14
isdl.weblogs.us,Conservative,8,0,8,19
itsafterglow.blogspot.com,Conservative,0,0,0,0
itscomedowntothis.blogspot.com,Conservative,2,1,3,1
itznewstome.blogspot.com,Conservative,34,1,35,310
jacklewis.net,Conservative,16,0,16,33
janegalt.net,Conservative,69,26,95,1311
jchristopherfeng.com,Conservative,2,0,2,1
jeffblanco.blogdrive.com,Conservative,35,3,38,75
jenjuskhan.blogspot.com,Conservative,0,0,0,0
jewishworldreview.com,Conservative,36,6,42,139
jg-spot.blogspot.com,Conservative,6,0,6,8
jihadwatch.org,Conservative,50,0,50,206
jlynnsmith30.blogspot.com,Conservative,8,1,9,13
joatmoaf.typepad.com/i_love_jet_noise,Conservative,13,1,14,28
joepublicus.blogspot.com,Conservative,10,0,10,14
johngalt.us,Conservative,0,0,0,0
johnkerrymustlose.com,Conservative,1,3,4,4
johnnbrown.blogspot.com,Conservative,1,1,2,0
jokerstotheright.blogspot.com,Conservative,12,0,12,16
joshferguson.blogspot.com,Conservative,6,0,6,7
journals.aol.com/lily990016/pissoffliberals,Conservative,2,0,2,0
journals.aol.com/mark24609/myblog,Conservative,1,0,1,0
jperspective.com,Conservative,7,0,7,6
jquinton.com,Conservative,69,2,71,794
jrogg.blogspot.com,Conservative,14,1,15,25
juntoboys.blogspot.com,Conservative,10,0,10,15
justalkin.us,Conservative,3,0,3,1
kalblog.com,Conservative,10,4,14,22
kausfiles.com,Conservative,38,14,52,444
keithy1028.bravejournal.com,Conservative,3,0,3,1
kellipundit.blogspot.com,Conservative,31,0,31,165
kenshepherd.blogspot.com,Conservative,0,1,1,0
kevincourser.blogspot.com,Conservative,3,0,3,3
kimdutoit.com/dr/weblog.php,Conservative,51,0,51,456
king-of-fools.com,Conservative,41,1,42,313
kitchennetwork.blogspot.com,Conservative,11,0,11,20
kushreport.com,Conservative,0,0,0,0
la4israel.org/wordpress,Conservative,42,1,43,254
ladymac.com,Conservative,18,1,19,57
lahargis.blogspot.com,Conservative,2,0,2,1
lancehaun.com,Conservative,0,0,0,0
larsonreport.com,Conservative,0,2,2,1
lashawnbarber.blogspot.com,Conservative,3,0,3,3
lashawnbarber.com,Conservative,212,7,219,3354
laughatliberals.com,Conservative,3,0,3,0
laughingwolf.net,Conservative,53,2,55,503
lawguy.blogspot.com,Conservative,43,3,46,381
valuerightnews.blogspot.com,Conservative,15,0,15,32
leftcoastconservative.blogspot.com,Conservative,16,0,16,40
leftnuts.com/runcms/modules/news,Conservative,0,0,0,0
legendgames.net/myblog.asp,Conservative,68,2,70,416
libertarianjackass.blogspot.com,Conservative,9,7,16,69
life.laptoplobbyist.com,Conservative,0,0,0,0
literatevalues.org/virtue.htm,Conservative,0,0,0,0
littlegreenfootballs.com/weblog,Conservative,194,14,208,3345
littlegreenfootballs.com/weblog/weblog.php,Conservative,23,2,25,99
littletinylies.com,Conservative,10,0,10,21
livejournal.com/users/bambenek,Conservative,20,0,20,71
livinginbabylon.blogspot.com,Conservative,5,0,5,3
lonewacko.com,Conservative,13,13,26,124
longdukdong44.blogspot.com,Conservative,0,0,0,0
loosecoin.blogspot.com,Conservative,2,0,2,2
louisville.edu/~bebusc02/blog/notarobot.html,Conservative,0,0,0,0
lt-smash.us,Conservative,58,3,61,425
lucianne.com,Conservative,35,1,36,151
luxeword.com,Conservative,16,1,17,52
madanthony.org,Conservative,7,0,7,12
made4theinternet.blogspot.com,Conservative,43,3,46,296
madtechspeaks.blogspot.com,Conservative,23,1,24,64
magnificentfreedom.us,Conservative,5,0,5,5
manifestcontent.net,Conservative,14,1,15,40
mantic.squarespace.com,Conservative,3,0,3,1
mariestwocents.blogspot.com,Conservative,22,0,22,67
markheimonen.blogspot.com,Conservative,1,67,68,678
markmeador.blogspot.com,Conservative,0,0,0,0
marknicodemo.blogspot.com,Conservative,27,0,27,55
marksteyn.com,Conservative,28,1,29,69
martinipundit.com,Conservative,93,4,97,1263
martydee.com/poligov,Conservative,2,0,2,0
marylandpolitics.blogspot.com,Conservative,0,0,0,0
masononline.biz,Conservative,0,0,0,0
matthewstinson.com/blog,Conservative,8,2,10,26
mattresspolice.com,Conservative,11,4,15,34
maybeithinktoomuch.com,Conservative,18,0,18,48
mc256.blogspot.com,Conservative,0,0,0,0
mcpheet.com,Conservative,0,0,0,0
mdcbowen.org/cobb,Conservative,20,1,21,81
meckz.net,Conservative,2,0,2,1
mementomoron.blogspot.com,Conservative,16,1,17,30
mercreport.blogspot.com,Conservative,0,0,0,0
messopotamian.blogspot.com,Conservative,30,3,33,132
metallicity.com/mb.asp,Conservative,7,0,7,10
mhking.mu.nu,Conservative,74,0,74,735
michaelsavagelistener.blog-city.com,Conservative,0,0,0,0
michaeltotten.com,Conservative,62,19,81,1151
michellemalkin.com,Conservative,215,14,229,3415
midwestrightwingers.blogspot.com,Conservative,22,1,23,79
mikesamerica.blogspot.com,Conservative,4,1,5,0
millers_time.typepad.com,Conservative,5,0,5,6
mindspring.com/~gsb3/blogger.html,Conservative,1,0,1,0
mobile.blogcastlive.com,Conservative,8,0,8,12
moorewatch.com,Conservative,27,1,28,32
mostlycajun.com,Conservative,1,0,1,0
motgs.com,Conservative,44,2,46,494
mtvirtus.blogspot.com,Conservative,48,2,50,476
mudandphud.blogspot.com,Conservative,39,2,41,253
mudvillegazette.com,Conservative,81,1,82,787
musicfromthebluelight.com/b,Conservative,6,0,6,5
mwilliams.info,Conservative,35,1,36,259
my2cent.blogspot.com,Conservative,9,0,9,13
myaisling.blogspot.com,Conservative,16,1,17,65
mycatharsis.com,Conservative,2,0,2,1
mydamascusroad.blogspot.com,Conservative,3,0,3,3
myechochamber.blogspot.com,Conservative,4,0,4,2
mypetjawa.mu.nu,Conservative,92,1,93,1078
myworldview034.blogspot.com,Conservative,0,0,0,0
nakedrepublic.com,Conservative,0,0,0,0
nashvilletruth.blogspot.com,Conservative,3,0,3,1
nationalbird.net,Conservative,2,1,3,1
nationalcenter.org/blog.html,Conservative,79,2,81,924
nationalnewsregister.com/modules/wordpress,Conservative,1,0,1,0
nationalreview.com/thecorner,Conservative,113,30,143,1744
nationalreview.com/thecorner/corner.asp,Conservative,5,2,7,8
nelslindahl.net,Conservative,0,0,0,0
neoconservatives.blogspot.com,Conservative,1,0,1,0
neoconswatch.blogspot.com,Conservative,2,1,3,2
neonbrainiac.nu/mt/blog,Conservative,3,0,3,3
nerepublican.blogspot.com,Conservative,99,3,102,1409
neverwrongnever.blogspot.com,Conservative,3,1,4,1
newcounterculture.com/log,Conservative,57,1,58,505
newsbloggers.blogspot.com,Conservative,2,0,2,0
newsjungle.blogspot.com,Conservative,0,2,2,1
newsnik.com,Conservative,2,0,2,2
nicedoggie.net,Conservative,121,7,128,1727
nickiegoomba.blogspot.com,Conservative,38,0,38,198
nicoladellarciprete.blogs.com,Conservative,2,1,3,0
noguru.tblog.com,Conservative,11,0,11,20
nomayo.mu.nu,Conservative,39,0,39,313
nonboxthinking.blogspot.com,Conservative,4,0,4,4
nykola.com,Conservative,16,0,16,62
o4tom.blogspot.com,Conservative,3,0,3,5
officesmileman.com,Conservative,11,0,11,27
ofthemind.blogspot.com,Conservative,36,6,42,363
ogresview.blogspot.com,Conservative,14,0,14,36
okieonthelam.com,Conservative,30,4,34,202
oldfashionedwhippersnapper.blogspot.com,Conservative,3,1,4,0
onthewire.blogspot.com,Conservative,2,0,2,0
opiniontimes.blogspot.com,Conservative,9,1,10,15
opiniontimes.com,Conservative,3,0,3,1
oppb.com,Conservative,14,0,14,33
orthogonian.blogspot.com,Conservative,1,0,1,0
outsidethebeltway.com,Conservative,129,25,154,2940
pajamaeditors.blogspot.com,Conservative,20,0,20,48
pajamahadin.com,Conservative,19,2,21,124
pajamajournalist.blogspot.com,Conservative,10,3,13,40
palominas.blogspot.com,Conservative,4,0,4,0
papadoc.net/pinkflamingobar.html,Conservative,54,1,55,542
pardonmyenglish.com,Conservative,85,2,87,1026
patrickmcclarty.blogspot.com,Conservative,8,3,11,28
patrickruffini.com,Conservative,60,2,62,848
patriot-paradox.com,Conservative,27,0,27,164
patriotblog.com,Conservative,7,0,7,12
patriotism101.blogspot.com,Conservative,22,0,22,70
patriotsforbush.com,Conservative,31,1,32,199
patterico.com,Conservative,75,3,78,1143
pejmanesque.com,Conservative,102,12,114,2127
pennsylvanianinexile.blogspot.com,Conservative,6,0,6,6
perryvsworld.blogspot.com,Conservative,0,4,4,8
philomathean.blogs.com,Conservative,19,0,19,74
piano-tuning.net/blog,Conservative,26,0,26,98
planetsuz.blogspot.com,Conservative,0,0,0,0
poeticvalues.blogspot.com,Conservative,1,12,13,60
polialaska.blogspot.com,Conservative,0,0,0,0
poliblogger.com,Conservative,90,10,100,871
polipundit.com,Conservative,95,4,99,1075
politicalanimals.blogspot.com,Conservative,0,1,1,0
politicaldogs.org,Conservative,4,0,4,3
politicalhyperbole.blogspot.com,Conservative,0,0,0,0
politicalmusings.net,Conservative,53,6,59,655
politicalpie.modblog.com,Conservative,7,1,8,11
politicaltracker.com,Conservative,17,1,18,100
politicaltracker.com/blog/weblog.php,Conservative,15,1,16,80
politicalvicesquad.blogspot.com,Conservative,6,0,6,4
poorandwhite.blogspot.com,Conservative,0,0,0,0
poorjustin.blogspot.com,Conservative,3,0,3,1
poptext.blogspot.com,Conservative,0,0,0,0
poweragerambleson.blogspot.com,Conservative,32,0,32,148
powerlineblog.com,Conservative,210,26,236,3902
powerpundit.com,Conservative,78,7,85,980
powervacuum.org,Conservative,1,0,1,0
prayforbush.blogspot.com,Conservative,0,0,0,0
presidentreagan.info/discussion,Conservative,8,0,8,5
professorbainbridge.com,Conservative,73,11,84,1027
prolifeblogs.com,Conservative,38,1,39,184
propagandamachine.blogspot.com,Conservative,15,0,15,44
prosandcons.us,Conservative,16,1,17,79
punditguy.com,Conservative,21,1,22,64
punditz.journalspace.com,Conservative,10,1,11,9
qoae.net,Conservative,16,2,18,29
quante.blogspot.com,Conservative,16,2,18,83
quibbles-n-bits.com,Conservative,11,1,12,43
quimundus.modblog.com,Conservative,1,0,1,0
quimundus.squarespace.com,Conservative,4,0,4,0
r21online.com,Conservative,2,1,3,2
r2korn.blogdrive.com,Conservative,4,0,4,4
rabner.blogspot.com,Conservative,4,0,4,5
radioequalizer.blogspot.com,Conservative,13,0,13,32
raincrossblog.com,Conservative,1,0,1,0
randomjottings.net,Conservative,16,1,17,73
rant.st,Conservative,2,0,2,0
ratherbiased.com/news,Conservative,13,0,13,28
rathergate.com,Conservative,34,1,35,307
realclearpolitics.com,Conservative,108,14,122,1233
realordeal.blogspot.com,Conservative,11,1,12,9
rebelrouser.net/v-web/b2/index.php,Conservative,0,0,0,0
rebrand-democrat.txfx.net,Conservative,3,0,3,4
reckersau.blogspot.com,Conservative,19,0,19,63
redmindbluestate.blogspot.com,Conservative,29,2,31,108
rednyc.blogspot.com,Conservative,14,2,16,60
redstate.org,Conservative,85,7,92,1098
redstatealliance.blogspot.com,Conservative,14,0,14,49
reggiescorner.blogspot.com,Conservative,2,0,2,0
regimechangeiran.com,Conservative,19,0,19,113
renpro.kwcom.net,Conservative,1,0,1,0
reporterette.com,Conservative,16,1,17,68
republicanpower.blogspot.com,Conservative,0,0,0,0
republicanresearchcouncil.blogspot.com,Conservative,0,0,0,0
republitarian.org,Conservative,0,0,0,0
republog.net,Conservative,13,4,17,46
respublica2004.blogspot.com,Conservative,22,0,22,103
retiredwarrant.blogdrive.com,Conservative,9,0,9,8
revone.net/jarhead,Conservative,0,1,1,0
rfburnhertz.net/rf_blog,Conservative,15,0,15,55
richmar.blogspot.com,Conservative,1,0,1,0
right-magazine.com/blog,Conservative,0,0,0,0
right-thinking.com,Conservative,34,0,34,71
rightcrusade.blogspot.com,Conservative,0,0,0,0
rightmoment.blogspot.com,Conservative,17,2,19,70
rightonred.net,Conservative,36,6,42,289
rightperspective.net,Conservative,1,0,1,0
rightrainbow.com,Conservative,17,0,17,41
rightreadingroom.com/index.php,Conservative,0,0,0,0
rightstate.blogspot.com,Conservative,7,0,7,7
rightvoices.com,Conservative,22,0,22,84
rightwingbastardo.blogspot.com,Conservative,1,1,2,0
rightwingbob.com,Conservative,4,0,4,3
rightwingdude.squarespace.com,Conservative,1,0,1,0
rightwingjournal.blogspot.com,Conservative,5,0,5,0
rightwingnews.com,Conservative,119,4,123,1874
rightwingthinking.blogspot.com,Conservative,5,0,5,0
rightwingtroll.blogspot.com,Conservative,15,0,15,31
rightword.blogspot.com,Conservative,21,1,22,82
riteturnonly.blogspot.com,Conservative,13,0,13,27
rmcdaniel.blogspot.com,Conservative,0,0,0,0
rncnyc2004.blogspot.com,Conservative,0,0,0,0
robbernard.com,Conservative,29,1,30,170
robertp17.blogspot.com,Conservative,2,0,2,0
rockpaperscissor.blogspot.com,Conservative,6,1,7,9
rockpaperscissors.blogs.com,Conservative,2,0,2,0
rogerlsimon.com,Conservative,103,11,114,2324
romeocat.typepad.com,Conservative,14,2,16,40
ron-james.com/blog,Conservative,3,0,3,1
rosenblog.com,Conservative,50,2,52,452
roseoftheknights.com/yank/pride.html,Conservative,41,0,41,249
roughstock.blogspot.com,Conservative,5,0,5,5
ryanshead.com,Conservative,8,0,8,16
salestaxusa.com,Conservative,0,0,0,0
samizdata.net/blog,Conservative,74,17,91,1378
sarcasticsoutherner.blogspot.com,Conservative,14,3,17,75
sarebabe.blogdrive.com,Conservative,0,0,0,0
sayanythingblog.com,Conservative,75,6,81,791
scha-den-freu-de.blogspot.com,Conservative,60,13,73,988
scrappleface.com,Conservative,105,9,114,973
scrawlville.com,Conservative,1,0,1,0
sebourn.com/weblog,Conservative,6,0,6,8
section-31.blogspot.com,Conservative,25,1,26,211
secureliberty.org/,Conservative,33,0,33,313
sedenteanimo.com,Conservative,7,2,9,12
selfish-souls.com/blog,Conservative,1,0,1,0
sgtstryker.com,Conservative,37,5,42,341
shadydowns.blogspot.com,Conservative,8,0,8,14
shakingspears.blogspot.com,Conservative,31,0,31,203
shallows.blogspot.com,Conservative,3,0,3,0
sharpeblog.cybercatholics.com,Conservative,2,0,2,0
shortfatcorporal.blogspot.com,Conservative,3,1,4,2
sickofliberals.blogspot.com,Conservative,1,0,1,0
sinfactor.blogspot.com,Conservative,8,0,8,15
sistertoldjah.com,Conservative,19,1,20,96
sixmeatbuffet.com,Conservative,40,0,40,286
skinmeister.name,Conservative,0,0,0,0
slantpoint.com,Conservative,42,1,43,343
slingsnarrows.erudite-absurdity.com,Conservative,5,1,6,11
slipofthepen.blogspot.com,Conservative,5,0,5,5
slowplay.com,Conservative,57,2,59,718
slublog.blogspot.com,Conservative,44,2,46,538
smarthomeschool.com,Conservative,1,0,1,0
smashingzero.blogspot.com,Conservative,2,1,3,0
smellyduck.blogspot.com,Conservative,3,0,3,3
sneakeasysjoint.com,Conservative,14,0,14,37
sondrak.com,Conservative,30,3,33,151
sonsoftherepublic.com,Conservative,0,0,0,0
soundingthetrumpet.blogspot.com,Conservative,18,0,18,79
southernappeal.blogspot.com,Conservative,64,9,73,803
southernrightwingextremist.blogspot.com,Conservative,3,0,3,0
southernwatch.blogspot.com,Conservative,34,2,36,292
speculativepolitics.blogspot.com,Conservative,0,0,0,0
spreadingunderstanding.blogspot.com,Conservative,36,0,36,158
spydrzweb.blogspot.com,Conservative,2,0,2,0
squiggler.braveblog.com,Conservative,8,0,8,6
stan-istan.blogspot.com,Conservative,4,0,4,4
stealthebandwagon.blogspot.com,Conservative,4,0,4,1
stillmanvalley.org/aoo,Conservative,25,0,25,125
stinkbait.blogspot.com,Conservative,0,0,0,0
stix1972.blogspot.com,Conservative,14,1,15,62
stmonk.blogspot.com,Conservative,18,0,18,69
stolenthunder.blogspot.com,Conservative,14,0,14,59
strategicintelligence.blogspot.com,Conservative,45,0,45,444
streetlog.typepad.com,Conservative,16,1,17,38
sulliwatch.blogspot.com,Conservative,0,0,0,0
summation.net,Conservative,1,0,1,0
sweetgrrrl.blogspot.com,Conservative,6,0,6,3
swfwithattitude.blogspot.com,Conservative,4,0,4,1
swiftreport.blogs.com,Conservative,0,8,8,14
tagorda.com,Conservative,41,17,58,751
talesofawanderingmind.blogspot.com,Conservative,9,4,13,27
talkshowamerica.blogspot.com,Conservative,16,0,16,82
techievampire.net/wppol,Conservative,111,3,114,1724
techtrend.com/blog/taranicole,Conservative,2,0,2,2
tedlinczak.com,Conservative,0,0,0,0
templeofjennifer.com/blog,Conservative,17,0,17,55
tepid-observer.blogspot.com,Conservative,4,0,4,4
texasbug.blogspot.com,Conservative,20,1,21,61
thatliberalmedia.com,Conservative,41,0,41,229
the-torch.com,Conservative,2,0,2,2
theamericanmind.com,Conservative,40,6,46,590
thebloghill.blogspot.com,Conservative,2,0,2,1
thecommonvirtue.com,Conservative,25,5,30,217
theconservativezone.com,Conservative,10,1,11,43
thecrankfiles.blogspot.com,Conservative,14,0,14,40
thedailygoodnews.com,Conservative,1,0,1,0
thedispatch.blogspot.com,Conservative,2,0,2,2
thedonovan.com,Conservative,38,0,38,283
thedumbdemocrat.blogspot.com,Conservative,0,0,0,0
theglitteringeye.com,Conservative,30,10,40,345
thejessefactor.blogspot.com,Conservative,28,0,28,94
thelastword.blogdrive.com,Conservative,9,1,10,5
theliberalslies.blogspot.com,Conservative,10,0,10,25
themeofabsence.com,Conservative,1,0,1,0
theneo-progressive.blogspot.com,Conservative,19,0,19,49
thenudnikfile.blogspot.com,Conservative,21,0,21,104
thepatriette.com,Conservative,82,0,82,1009
thepaytons.org/essays/considerettes,Conservative,14,2,16,56
thepoliticalanimal.com,Conservative,52,4,56,692
thepoliticalteen.net,Conservative,51,0,51,391
therightblog.blogspot.com,Conservative,22,2,24,135
therightcoast.blogspot.com,Conservative,27,4,31,174
therightwingconspiracy.org,Conservative,38,0,38,374
therinsecycle.com,Conservative,3,0,3,2
therostra.blogspot.com,Conservative,3,0,3,2
thesakeofargument.com,Conservative,4,2,6,5
thespoonsexperience.com,Conservative,43,1,44,365
thetarpit.blogspot.com,Conservative,15,0,15,43
thetemplarpundit.blogspot.com,Conservative,22,1,23,105
theunderscore.blogspot.com,Conservative,19,1,20,64
theurbangrind.blogspot.com,Conservative,20,0,20,83
thevaticanofliberalism.com,Conservative,28,0,28,179
thinkingright.blogspot.com,Conservative,0,0,0,0
thinkingright.us,Conservative,24,2,26,187
thisliberal.com,Conservative,17,0,17,51
thomasgalvin.blogspot.com,Conservative,79,14,93,1504
thomaswharry.com,Conservative,1,0,1,0
timblair.net,Conservative,75,5,80,1268
timblair.spleenville.com,Conservative,59,13,72,1050
tokenyoungconservative.blogspot.com,Conservative,18,0,18,76
tom-hanna.org,Conservative,22,0,22,58
toneofvoice.blogspot.com,Conservative,3,0,3,1
totels.com/bush04,Conservative,3,0,3,1
townhall.com/clog,Conservative,34,3,37,348
truebluegal.blogspot.com,Conservative,18,1,19,60
truthlaidbear.com,Conservative,159,45,204,2540
truthliesandcommonsense.blogspot.com,Conservative,23,0,23,63
truthprobe.blogspot.com,Conservative,24,22,46,487
tseytlin.blogspot.com,Conservative,2,0,2,0
tsrightdominion.blogspot.com,Conservative,21,3,24,99
tuckereskew.typepad.com,Conservative,3,0,3,4
tweetpetite.blogspot.com,Conservative,0,0,0,0
twentyfirstcenturyrepublican.blogspot.com,Conservative,16,2,18,41
txfx.net,Conservative,29,1,30,211
unconventionalwisdom.typepad.com,Conservative,14,2,16,81
undercaffeinated.com,Conservative,4,0,4,0
underscorebleach.net/content/jotsheet,Conservative,1,0,1,0
unfetteredmusings.blogspot.com,Conservative,19,0,19,124
unusualhabits.blogspot.com,Conservative,3,0,3,1
usdlaw.blogspot.com,Conservative,12,0,12,32
vandyconservative.blogspot.com,Conservative,0,0,0,0
vapolitics.info,Conservative,0,0,0,0
variousorthodoxies.com,Conservative,3,0,3,4
victorhanson.com,Conservative,46,0,46,170
viewfromaheight.blogspot.com,Conservative,18,0,18,112
viewfromtonka.blogspot.com,Conservative,12,0,12,22
viewpointjournal.com,Conservative,9,0,9,27
vikingpundit.blogspot.com,Conservative,75,5,80,1505
virginiapolitics.blogspot.com,Conservative,13,0,13,43
vodkapundit.com,Conservative,150,22,172,4523
voiceofthewebb.blogspot.com,Conservative,0,0,0,0
volokh.com,Conservative,97,34,131,2422
vondollens.us,Conservative,0,0,0,0
vote4georgew.blogspot.com,Conservative,0,0,0,0
wanderingmind.blog-city.com,Conservative,0,0,0,0
warriorscreed.000k3.com,Conservative,1,0,1,0
watchandwait.blogspot.com,Conservative,3,0,3,0
watdanook.blogspot.com,Conservative,4,0,4,4
web.utk.edu/~agroves,Conservative,2,0,2,1
wehavesomeplanes.blogspot.com,Conservative,18,0,18,138
whatsakyer.blogspot.com,Conservative,15,0,15,50
wholewheatblogger.com,Conservative,13,5,18,43
wildweasel.blog-city.com,Conservative,1,0,1,0
williamwebbdotorg.blogspot.com,Conservative,26,0,26,187
winceandnod.blogspot.com,Conservative,13,1,14,39
windingroad.typepad.com,Conservative,0,14,14,50
windsofchange.net,Conservative,89,19,108,2165
wizbangblog.com,Conservative,198,22,220,4335
wrighthot.com,Conservative,0,0,0,0
writehouse.us,Conservative,1,0,1,0
writingcompany.blogs.com/this_isnt_writing_its_typ,Conservative,52,4,56,698
xanga.com/eugene3,Conservative,0,0,0,0
xanga.com/lockjawtheogre,Conservative,2,0,2,0
xtremerightwing.net,Conservative,3,0,3,2
youngconservative.blogspot.com,Conservative,3,0,3,0
zebrax.blogs.com,Conservative,19,0,19,40
zeke01.blogspot.com,Conservative,1,0,1,0
zeke01.typepad.com,Conservative,22,0,22,84
zeph1z.tripod.com/blog,Conservative,0,0,0,0
